**************************************
*       MassShadow Hackers           *
*   Edit My Face - Database leak     *
*           23/06/2018               *
**************************************

TARGET: 
  COMPANY: OneSmile Inc.  
  PRODUCT: Edit-My-Face

1913 credentials (username pass)
---
7moneybooks	ninja
Mlobbistka	pastor
eRegnov	hardcore
7lilmermz	Ashley
rtheredglove	princess1
8sasinabo	Bitch
Jlleithan	elizabet
eMinistru	tucker
Xcuitewai	thomas
Tgwaedogen	chris1
3sifihle	eagles
Vsimplitge	work
ILovrovich	rangers
Itextur	hallo
zdaimana	Jessica
Pcoheta	lakers
xnichie	shannon
9uvalam	heather
rtijuanapress	christ
kevuswa	jennifer
1Anfray	somethin
Nunrelvivone	porsche
JSmachetti	prayer
Spatzig	darkness
Paremoza	compaq
yslercenue	darkness
Lorriblas	microsoft
TGiniSleenty	samantha
Xautoland	blessed
Oenergetik	cocacola
ibuhZefNeubs	Terminator
Csun328	summer06
ltalonee	whocares
Unuosaika	myspace1
2Zweipunkt	maggie
qdaimana	password2
Zizume	consumer
erealis	ashley1
Asynser	fuckyou2
XUrson	hannah
Man5d2i1f	jordan
Funamundoxia	porsche
pazar80	charlie
9vivac	lauren
RLienitis	snoopy
Falesenferia	angel
Nmpeta	bubbles
Ekayhojai	Bitch
ghorkai	princess1
lTimurian	red123
Hplkcc67b0810	thunder
FEdelziege	christ
echarleeeeene	crystal
crastresen	joewein
BamessInvany	blue
Oassaget	qwertz
Zremodeles	michelle
mte2m1ill	voodoo
UHilbert	cassie
xpareishes	freedom
Kkoraljnim	work
Zlefair	2000
uorguljem	orange
rrevegi	computer
oaztecsanchez	abc123
6sakleysur	red123
zvegirnir	pastor
Bngembi	sunshine
rNaidu	jonathan
omagerte	golf
Vjeppy79	Ashley
qmimisbook	bullshit
1jafnlyndi	football
tscpaul9012	snowball
0fregall	butterfl
pharttun	genesis
BFekonjama	butter
Fdilse190	aaaaaa
ajarizzle151	princess1
Ewatumwa	123123
nFliedgole	adidas
pgynheswyd	john
Bmumlja	raiders
8Cadario	diamond
Pandresroche	thomas
rrie03	qwerty12
EVolkslied	swordfis
Pzog	gundam
Ctalij	nicholas
Emercejant	microsoft
3richellg	welcome
kJakobiner	maverick
jsynorgy	jennifer
bobrisala	horny
Nlabilno	asdf
claguiadetv	password
Tstrozze	nintendo
Rvictorcyuen	yamaha
ljwyang	159753
gtochtvrij	james
ySzeklerom	pumpkin
fJuinofeef	angel
jsacbwt	tigers
Snzija	666666
nkudjelja	rosebud
Aproveden	123qwe
gnertha	blue
9argansats	matthew
Xshaka375	hammer
dgloomsan	anthony
KSudeikiai	test123
nsolongmaryann	justin
wel4ke4e	hello1
Upartneru	friend
jluli	fender
9lee1ge4	Admin
jracanas	qwerty
zRecoba	steven
sTiefsee	1q2w3e4r
rmalesarria	shadow
0Graya	chicago
Htoti	ashley1
Pfematge	football1
Lorice	booboo
0e2uth	secret
XKlewno	eagles1
Itiguisiso	google
qede2tel	metallic
qbeginzet	starwars
mdalvindur	ginger
MBrautwahl	iloveyou2
amatema2	0000
Fcidrex	summer06
Pzenaide	pass
adysby	snoopy
0aufondagauche	gawker
3mantidas	loving
Ednewaza	porn
rgiliasid	simpsons
4amusias	qwert
NOslej	turtle
0Immun	pass
Itrevare	peanut
GZanonzini	131313
Udoxbloony	hahaha
3MoorbMooreose	rangers
wsmeleplosyRep	letmein
Avroulis	passw0rd
5Kupidem	pookie
6alargatz	knight
4tayole	nothing
zsoleg00d	rainbow
iValdesio	calvin
jdzigna	heaven
3fletching	lakers
Wvegirnir	volcom1
etenedora	buster
fporubkai	destiny
4Einsehen	Terminator
5kujo007	wisdom
mnotomelo	mother
namigosdaniel	redsox
nemalini	flower1
7ljetinama	testtest
ldepozice	xxxxxx
wAufwurf	adidas
0syttini	rachel
1giortacht	spirit
7inayos	ginger
trondvaar	marine
Qalheitada	drowssap
Iwibgart	password
wgrodza	booger
AAddedaHic	123456
JMarysin	metallic
dArlondi	compaq
nFeetstemstype	1qaz2wsx
Eyamih	mercedes
MFleretov	iceman
iheimskole	hunter
Eapareced	pookie
fKocljema	golfer
7on3d4u	prince
ticeman83	internet
EMamyCanyDally	123456789
6krajni	simpsons
KFalivelli	tucker
Ytwikifitrerce	canada
7Kisfaludy	penguin
fl3ly1g	horny
Mbeatmeplease	fuck
Pmuridslogfr	8675309
Nesbriats	cookie
bcicise	jonathan
Pkordialny	sophie
2Mabylle	joseph
Aanndroid	scooter
choloubek	666666
Palduorku	112233
cdefenossi	austin
8opsesijom	jasper
wBergtod	poopoo
Knatezala	mustang
6zesia	raiders
Wverbannen	andrew
bmarkantan	aaaaaa
ASaftthusa	hannah
Hrottamaia	red123
MAlfarb	writer
iabmisst	welcome
Bbespannen	brooklyn
prhosedau	12345678
6almupetty9	1234567
Ceob4r	james
1DowDegree	rachel
Rbritanyjolie	voodoo
pemitremus	gizmodo1
Zmelktank	:the
mi2j1w	redsox
hBelska	qwerty1
Ahyper	rosebud
hdavidmoreno	jasper
Zadarydd	pokemon
0Rajlich	player
8inklini	heslo
ZHauspie	ncc1701
Bibeka	phoenix
Hdesblocar	fuckyou2
Upekabaran	fuckyou2
SBageowetPag	friends
ibrusheneunc	maxwell
Xv8nsx	remember
CRetzstadt	letmein
lcytotoxic	angels
WFascie	smokey
nRenoinfox	trinity
Xfalwyd	birthday
iGeomiaDioplop	chris1
onaslajal	andrew
Bzavjerama	writer
mtombacs	nothing
zVaale	joshua
Vdomestik	devil
vsjeveru	orange1
uGosz	123456a
1betroud	oliver
okobeyoux7	Password
umyte	jessica
Opprpnk116	Bitch
Rdaganna	please
Gdondable	cameron
8justinvikk	soccer1
Kahenhava	nicholas
Yshanith	1234
dpreleteti	qwert
6luirg	nicole1
Ecyber2	1111
oconfusedwithu	elizabet
frayneing	cowboy
6sanmateocf	qervy
Upski	xxx
abastynu	richard
ENotenbank	7777
eostudnic	robert
Ssladaigh	test123
0bijednost	kotaku
0PelaroommaDop	qwert
ytheoremau	hockey
9ukuvezwa	carlos
rmagdalene	Password1
epenta	liverpool
wnkenerwa	internet
sgead	danielle
wdescendre	rangers
Benrelhant	knight
wPoliken	google
Gcarolenounou	chester
yneospeed230	enter
tkarynscottage	gizmodo1
Aoklevamo	Football
oChinelato	cool
3Borbels	princess1
pskypeshoork	andrew
tconcais	butter
llesqueta	november
cotemnil	gizmodo1
Esmarka	chelsea
zAnvar	jordan
7duorjend	gawker
Bdictavas	jezebel
Vowayefuna	Terminator123
Xheigiadau	panther
6waterbell	q1w2e3r4
scchcsmk	emmanuel
Todtehtam	black
Ieyeoh	single
Cfua6f5ara	nirvana
Kacechanza	Password1
kmayliu	corvette
Kdissi	abc123
zFloaccall	superman
Llilchristysim	hope
Lwizardp00f	writer
bstrukture	ninja
Rsavagegierden	Password1
5SetsTosymom	mustang
sespepidat	steelers
4talegetz	jennifer
9Baldusso	spiderma
h2stp	soccer
muletse	football1
gexprime	chicago
addude965	Password2
EZelandka	creative
pMDII	carlos
Cmychanson	superman
wmythos	chicken
CNwabalogu	
Vyamilink	jordan23
htiwtor	monster
grockizero	mustang
83be1f	matthew
Fgyneua	nicole
Gcorven	123
TBierhahn	please
Vfrench210	love
jabgeraten	panties
Tlamahobhe	apples
usursuipaniall	Password2
8rockxx	gizmodo1
preesehux	hallo
ijaymnes31	forever
NAstwerk	football
ftmp	gawker
cs3jakt	admin123
3Gaddette	abcd1234
2abullonar	bigdick
pbylau	link182
sChylonia	porsche
7rastresen	robert
Btenny	Miley
Qegogin151	barney
Pkolonad	andrea
Smaiscomment	dragon
Jrabotada	batman
OSkirbst	boston
Yvatnamara	hooters
amrmango786	sammy
Dpremleval	friends
Lfleytirum	fuckyou
HLymnvinee	johnny
6strecoare	richard
lNicaEmpibiaph	foobar
vbububu	eagles
Rcanadianpizza	rockyou
snichie	mickey
6niyilethe	grace
wlomqoqo	Admin
Mbapske	soccer2
IKossa	dick
Pchikitavzla	soccer1
Cannt1que	genesis
8xapat	friend
Sstreljane	baby
Kfulminada	nirvana
lpazaka	sexsex
0fenasopadres	gateway
Aroberto540	159753
nBobbrorbinfoW	fuckyou!
Pzakitim	mylove
WCadspaddetA	pineappl
iRapak	Lovely
rclasicism	orange1
Rhymogelom	12345
8Agazio	naruto
EPettillo	angel1
2Ollscoil	pumpkin
tsonoor	madison
wnonyazi	mike
xpevali	xxx
Caliundro001	zxcvbnm
1esgob	shadow
Egesi	Bitch
dCalvanesi	summer1
Tarazzo	maxwell
Tasturhockey	faith
dHauspie	happy
4autosomal	miller
iduria	131313
fDelpinov	microsoft
1kandelaar	shannon
josnovni	compaq
Uryadjtn	iwantu
qkoldonet	patrick
pPiccegna	0000
Aderechoucn09	shannon
HColonetti	charles
Vsunglassmafia	smokey
Yestrilhi	charles
Amecedero	slayer
0immurryencome	link
qtralhes	saved
1arolwg	abc123
Npiemn	the
Kwaakhond	coolness
kvcabezacarpio	online
om2p3ach	adidas
oglavnin	wisdom
8harryinhk	anthony
jeguasser	tigger
YSomplar	yellow
0yatinoo	genesis
4attainer	microsoft
6Emr	thunder
XFarrace	xxx
kgubitku	job
Iprutom	bitch
mtypawl	morgan
7TEE	somethin
Ebuiscully	anthony
0koraljnim	angel1
UCRELVEORERDOX	pineappl
6skledast	december
6friedice6	junior
8cutiepig4none	iwantu
hpastors	gawker
vselypit	butry
jbiaceta	green
xCerottini	booboo
Ore0w	soccer
zcourtnay87	nicole
FJarca	power
8falune	1q2w3e4r
ynavybluejocky	jennifer
2copulato	the
fcrazyaznguy12	madison
6aarsdarm	startrek
Valluce	jennifer
9Ineleidenna	brandy
nacorre	november
Werizar	joshua
Ymauzoleja	hallo
8kerkje	qwert
Rbe1fl	fuck
Hniewylany	gizmodo
Xazogar	adidas
Qsemenkah	killer
Ucafeatau	Highlife
nakun	peaches
hjs3pac	andrea
Ganalmf	bigdog
Talanguiva	Miley
jffolios	shannon
6johnelvis	marine
EAntethynccase	steven
Lingelena	bailey
rsambok	fluffy
GNiewczas	rachel
Bfiremen	123456789
QMouches	bigdog
Qgewatteer	bigdaddy
Gumelala	fluffy
7amnandi	bullshit
Qtenentia	badboy
6miegem	lakers
qvodostaji	andrew
4profgustavo	123456789
xlawiad	liverpoo
Wlomhund	google
lmetcalfe	gizmodo
cdnewaza	golden
aorochicas	hunter
Ucarnetdethese	guitar
umin2608	midnight
hstrozze	red123
vlaciespagnolo	maddog
3dorably30	qwerty1
JMurrieri	banana
Tillavai	zxcvbn
xgelsvavo	dancer1
ETriebsch	passw0rd
xraspillar	valleywa
4tartra	8675309
Gashleyt072	mother
mmiejats	asdf1234
8festingin	fluffy
9Nocker	orange
iShieftPioth	shithead
Kplume07	slipknot
7gesnoerde	loving
YFirla	hammer
zGuloultNold	oliver
Nacetati	winner
ulonclesam	ilovegod
5phatbrighella	159753
oliberez	sexsex
pMeerhase	Lovely
foksel	matrix
gaustralsk	hello1
8CrarOrierve	corvette
Omermaidangel	heaven
wwwadmin    TExPASh
TOrtesio	dick
Malibaba12	church
Ioporaviju	startrek
7umetninah	sammy
he4t1w	123321
Hnimbusima	mother
Jra1p2re	Miley
1groteskam	samuel
mperhati	ilove
3Schuppe	love123
Sengausint	taylor
mrandiweigle	google
OAmazon	123123
lCochemer	chris1
Lsnakekileurs	grace
GMondpreis	fucker1
hmaturama	Password1
Mguijarros	1234
8giftig	bitch
szorhwebo	poopoo
Tstalnijih	samuel
Ujulesong	Fuck
eVitantoni	123456
sOmorogbe	asdfgh
Hhitas	bandit
DFahrtor	yellow
6fomichev	boomer
Mmelamar	batman
Kdotboxed	andrew
Kalibaba12	london
dflp4life9126	123qwe
Vgemdw	princess
1vanligir	hockey
Clancina	trustno1
3deviator	google
7Pilarz	soccer
Esoquejat	11111111
GValcatori	butter
Fvraer	angels
ad5s4ta1v2	123
vleereise	stupid
yrooballa11	morgan
Xmiejats	nothing
9umordemivida	pastor
lr0ckyr0gue	whatever
lgpocon	somethin
Usardonics	master
vangelutho	golden
9bluesman9	canada
ntukuto	kotaku
4Laufarzt	pokemon
Arumeur	jordan
PVati	crystal
Nblymiadau	nicole1
oosteodounwite	online
Cditchoven	soccer
aBassspiel	Lovely
3chynagyrrl	smokey
nIpayipi	booboo
Hrangory	david
tSielski	bigdaddy
Lcaptainziggy	austin
Idamak	mustang
ODonaasjes	steven
4anaele	kitten
fGingham	cowboy
Nguijarros	hello1
Mcovary	Lovely
pporgo	welcome
Gsmokeysgirl17	murphy
fbluzic	access
nciterior	qazwsx
oAlachas	ncc1701
5crazyaboutm3l	booboo
dDymnmasyOxymn	2000
palawbandy	butter
ahistorama	freedom
gvirtist	friend
Jnukaitino	abc123
Ssatanist	hahaha
eamelwe	ilovegod
NGoito	genesis
4gagnolio	8675309
Wkaypertsd	jesus
5delerada	:the
Dsna	midnight
hInemOwneniege	captain
3Degioia	whocares
8marilafrenchy	6969
wtrainiEremi	gandalf
hrealni	zxcvbnm
gtodopor2k	asshole1
Elantent	Qwerty
yAtorurtusia	snoopy
Vyebatali	lauren
csurety	qazwsx
Lelpelao29	7777
yaliundro001	6969
anekrokris1	raiders
iRoa	starwars
Gdubbelde	111111
Ycarpedi3m	testtest
3destrie	johnny
tselhatz	hotdog
UToimialmolf	fuckoff
1snowadikt013	heather
lnalu	buster
Itorregats	qazwsx
RZeugdruck	pookie
Hnakfera	zxcvbnm
Lkalandor	1111
HLaronca	pepper
mhonsut	spider
pOndr	welcome
Jlorgadh	mickey
ypatincouffin	Ashley
Lntagire	10423
aGavuzzi	jonathan
zteisiligh	q1w2e3r4
JOtisk	chris1
Dsajda	fucker
ogearworld	sex
0starsky007	link
9heimlandi	arsenal
RPozzallo	calvin
lmissyizi	gawker
Kblogencurso	pastor
Lmutiranje	golf
8lieknas	thunder
1imponuju	flower1
nSabiu	hello
Cvetvrij	sammy
mpymnwhacuappy	flower
lPodvihov	1111
Bmenseguns	creative
Xsakuraita	diamond
0caingean	guitar
EMFAdmin    1smileSuck!
ovetleimpeni	mustang
sni3tri	god
cblogueenstock	asdf
uragelj	slayer
zneduna	online
JPhammenna	sammy
Ebambusom	andrew
vgiros	prayer
Ccarucci	asdfasdf
xcinchit	green
Ghighjumper013	justin
Psementer	grace
uFlore	myspace1
rtlavelle831	chris1
tzurrar	edward
5bajocians	birthday
dvettechn08	boston
yphotovoyage	nicole1
Gdalma	ginger
ozeitweise	genesis
kren3a4r	tiger
IRumelia	shalom
JMigozzi	shadow
Ggudamu	nascar
Eaferrat	1111
dFahrsport	devil
Wlilshorty850	falcon
fPhywhebtexy	qwerty1
VFosforini	bulldog
ln5de	winner
3drefbomb	master
7orochicas	valleywa
Dmainit	orange
qnereemics	matrix
harreddir	madison
Bodele	player
ffamu	genesis
Jdeign	123
4enxautada	porn
Vslugman423	dexter
pSobolewo	poopoo
lpaisdeeme	biteme
r2h3vj	winter
RZewRefeelaw	maddog
Lbinavi	brandy
Pspoorvrag	seinfeld
Ydeusfire	fuckme
TcyclevefE	jesus1
Uhatie	camaro
0entribuli	qwert
hizmisliju	turtle
iblog33k	peaches
5vetvrij	Ashley
floyd400z8	Dick
stagetec06Pm	iloveyou1
legendgirlD1	cheer1
tsutsuxxxnA	victoria
magickamek7h	hotdog
UnoQp	Ashley
TrabellaJM	maverick
vjetrovitCF	hotdog
KorzikiFx	1111
versadigcL	online
sayansi9b	superman
Exterieurgt	batman
Miltitzsp	bandit
juvelartoJz	Terminator
mumij33	startrek
Isonamn	Terminator
klammernOq	taylor
haninakZ	maverick
WandlausdS	Ashley
minaratzjq	oliver
pastissisTg	soccer
Serokafh	flower1
tika1ie	hardcore
umahluko4h	fender
bokubaBN	cassie
dremapZ	adminsuck
hatszorosII	123456a
mackthinWN	fender
piratkamit4	aaaaaa
poteralapw	crystal
bernicsZX	asdf
Gareexiviceo1	coffee
MeamyineseeR4	maxwell
Gaumploopleah	maddog
inhariaGameBx	55555
demise8t	single
maritareDp	159753
kikoun47qW	nothing
2SLOV	apples
salfirirUw	drowssap
laescuelahaceBT	steelers
gynghorau0P	tigger
letrasprozacgj	fender
CodoonenryVemEu	love
soljenima4s	wizard
engrulhatKh	porsche
TukumVU	guest
pallaquesre	hello1
izglasaoH9	sophie
Drovydas6Z	1q2w3e
tia1055fW	panties
dotamaUu	:the
krkljancubb	slipknot
heedk6	0000
fernandoou	forever
mendigayviljI	hammer
eqondatg	stupid
besFuettyRu	victory
aireadasolashE	159753
silverxcacabk	booger
marlettygcm4	charlie
wersowyrM	silver
apeguivas2K	brooklyn
henessylarae4r	fender
kassabokxP	football1
isdekkeQE	blessing
arenatgB	redsox
bustych5j	turtle
haswirioEv	bigdog
wedbatteryEM	loving
preveientqZ	biteme
bostonjelloZO	starwars
musicaspencerqq	1q2w3e
silverxcacaJR	drowssap
rewakdf	smokey
lili78690Wc	phoenix
lilniffer6S	redsox
jugglingkilla8f	gandalf
zo2tJD	samuel
imendan88	jesus
enlausarEX	calvin
awafaniWr	fender
dvobimnN	cocacola
kk4C0	panties
seeniataptinkJ2	god
pypeelaxysG	
profesoniabgp	hahaha
TroupierUb	forever
aph5emg1	iwantu
ie1poLG	summer1
gaudellizP	hahaha
inismigmaq3	fuckyou!
czandive	Bitch
fushigikun8N	peanut
angiela1885xL	chicago
julylovegoodtZ	charles
archivavatf	rotimi
filistinniT	123
imantenFS	ginger
pinkcrayons12yZ	baseball
Flatzby1J	jack
kpmclub5U	Killer
mededeel33	butterfl
ChrestienFg	monkey12
hjallinhc	wizard
vioristjV	ashley
riaghailtzT	spirit
captivated49OU	jack
SionaQP	sunshine
morderca4l	harley
PenbrynHL	blink182
marquesa62ax	swordfis
UbumelicO	gandalf
desmedarFS	123
calliope2274L	cool
AnseithgD	benjamin
LelfneeconsG2	freedom
ghost1012W	butter
ilaff2mch42fi	william
rooiassieEf	000000
hoarjeTg	mercedes
RovedattioD	hello
sponioushCS	peanut
jsutafw	andrew
lassadersLj	chelsea
eolapazhq	pepper
Pedumkp	pineappl
dvigatiLG	football
milicahnS	darkness
lewdnessoD	microsoft
isplakahwJ	xxx
cpsmathUI	Qwertz
relibelatzn	single
xatlxflirtxqg	friend
jenntycakesde	patrick
pugiOm	canada
upptakaWf	online
ruiplefappicaAR	Terminator123
acabangaE7	666666
noovojobXJ	fuckyou
Laasov	consumer
vee3p4pD	maggie
odumirateaA	blessed
djeepy1jP	master
Peennabemjo	jordan23
colomista3z	gateway
greutaZj	austin
gokaciffignPc	matthew
Vrouw8O	iwantu
zwaliwszy13	penguin
zidarkamfJ	123qwe
t4ieRK	jordan
niewwianyLh	john316
soodareeskSok7X	fender
drietonig01	godzilla
komuszekuB	wordpass
brumenyE	apple
duodenal7A	buster
humusowyKM	cool
tefontieO	smokey
vidassatG	nicole
isusiweqo	qwerty
prekupiVL	maverick
illipbupsuildNM	mercedes
VytenisWD	fucker1
en1tu2t1vl	Qwerty
vi1keRQ	heaven
remuladeRY	johnny
UtknipteWI	blowme
swirlygirl10rb	flower1
podsvesnaZs	Terminator
mengansur46	1234567
ngresyniN6	Password
delerars3e	hello
elfeO8	654321
nanoweb8c	pineappl
wanalokaaKj	xxxxxx
fefusenKv	sex
mercurosaps	heather
snackisK	Terminator
CrenoFlisosse6T	carlos
sweswozW	volcom1
KubeckiA2	coolness
Dieselbussv	arsenal
nitrarsIQ	q1w2e3r4
symbolicatings1	volcom1
maroonereB	batman
andriDR	michelle
greenneckD6	drowssap
a2r1lCF	black
theaster1vk	barney
noMquluuA	diamond
depresieX2	love123
abaissat0z	chris1
Misocchiaia	love
le1pe2t124	1q2w3e4r
glicerics8S	purple
NiejimanaRy	zxcvbnm
oganusJG	asdfasdf
FalsaroniHC	Terminator
Boitzumhb	159753
spreletelHt	grace
azotemialR	kotaku
AbdraboLc	pussy
rimasteneP8	helpme
BluetteadebraeU	fuckme
zasebnonI	shannon
chartedBp	butry
incensatovE	hooters
OrnabbeceX2	love
abgefeilt8g	babygirl
Ceamaffog7X	snickers
awaiskNam0H	whocares
kosmicfreakhJ	butthead
NubeenaYs	hello123
kambamFX	shannon
gaia9Y	gizmodo
calistar98K	madison
Krencs5E	Terminator123
argenticsas	happy
ayuminemotoyY	cameron
MeareTofgofzT	iloveyou
ebullientkr	marine
krummar7	cowboys
loerganUc	cookie
moniment1R	123
lekarevuf6	dick
ComtomaOG	consumer
stringedZ6	hooters
lhiverabsoluwb	gizmodo
merenikKh	trustno1
ewesoSZ	shannon
eindspelGX	helpme
doskakaWl	zxcvbnm
teisiaJ0	creative
LutvercigG	lucky
Jellbydayna	qwerty
silaznimiJ	123456789
stonerGO	mercedes
obriransf	emmanuel
guilhaneNW	silver
Kladivusf	xxx
pissantaQT	11111
datumu1t	jezebel
chan168hkXQ	purple
footmindersKP	charles
ParachiQe	bitch
wolfchic7T	dancer1
Rencinai9K	chris
heffem71	basketba
fynbos1z	nicole1
Stadarib0	connect
tippetegnNs	william
rte4le2i2S	matrix
EisquadercD	church
hjartegodtC	wordpass
troillNS	liverpool
bebo4K1	asshole
surfaires2j	winston
mythirtytwoXR	shadow
bergkastKV	panties
alkottatDL	john316
Spini6	muffin
momall613NQ	banana
sportinityf	nascar
kecenaanKz	1q2w3e4r
mandy623623it	orange
WalAltecttevyGX	scooter
Brondib3	ncc1701
MMDXVIIIfv	brooklyn
amiexglamourlI	orange1
tdscng5K	Password1
Whelanej	tigger
twojejJ0	metallic
baziranihOs	whatever
trylle6o	slipknot
calieeloq	penguin
lovesdogs11Ds	tiger
AtronAbodsfobFO	password1
riwliaupm	ginger
zgrkaralarkO	abcd1234
sword88em	shadow
x0ticjaeVh	112233
wolandahR	password
aceitaA8	qwerty12
CzerwonevM	spirit
pinkcrayons12Kh	rachel
mattyxdy6	blowjob
alanwong999nP	dallas
salonsdartVx	london
lemezlD	junior
nicocheraS6	loving
NiblerzK	snowball
staustufeTI	london
RomaniFc	monster
ChromecwR	winston
armdickYM	lucky
tristancio35yZ	whocares
oecologieuU	liverpoo
shablemalmH	fuckme
6r5olympI	nascar
Bersrodbp	elizabet
Irraveniaq9	bulldog
3djurYx	maverick
horastatfU	jackson
ung3rQm	merlin
parenimaW4	soccer
iskemieLR	november
bisquetasbI	saved
baselesspM	fluffy
osornim7U	mypass
GermonioOK	deadspin
FirstlFb	lovely
Kotrcnx	fender
plee627JV	muffin
horohoatgi	buster
y2w1hHB	christ
silnikowyLC	football1
deperidaCH	cocacola
KurheimenUs	lovely
gerlannauRm	sex
workbenchQF	smokey
fjamsv5	hello
Atomlinieh9	phoenix
minorjm0	bitch1
sesahamlj	voodoo
eekachooRd	turtle
PirklzO	calvin
umandesC	chicken
xanzhar8w	mypass
iscelioiY	summer1
Toollennapv	chocolat
maluwizardEW	bubbles
OranioHx	iloveyou
vegetarUt	zxcvbnm
Everymangh	jack
pritegomgG	cassie
slanimagS	blink182
OdemdD	scooby
ventescasP1	canada
repaleigMu	1234
xsabrexansemxbj	mercedes
domujPG	rangers
aostinafZ	access
snapsieYP	coolness
babaecI	password1
Gearmailt08	genesis
ewilliams07rP	654321
akkadiskdd	boomer
g1l6S	george
adlunnochS6	poop
gooittF	testing
amourmangaYM	heather
celagurijc	Bitch
grasumit4	god
o3manIu	saved
petsang4v	1234
BranikaES	merlin
GiftopferDk	654321
KolfinnsH7	1q2w3e4r
deconstructljSq	penguin
castetatFn	thunder
entramVi	nigga1
starhaushinkaug	hooters
notsoshort5L	eminem
srokova34	123456
MoorryWaitazd	samantha
rakijugd	maggie
lf1iskhx	princess
mescitarh	job
capvire37	spanky
emomyFeaniaH3	fuckyou1
porodiljavU	blowjob
sivonjitc	poopoo
nierycie02	corvette
ojebovl	rachel
EPHELIAAFFERIuY	creative
batmanbynolanVn	112233
babybashmaminX	cookie
tutungo6r	boston
saboratVW	murphy
palhaire2L	winston
xlayziebabyzB	fuckyou1
BypeEncuppyDY	patrick
jaudasm1	testing
sunkinoi6	sunshine
uzdisaloCj	159753
cumaimER	bigtits
Leuprecht4q	voodoo
semiotikeRl	monkey1
saltishSR	pookie
straktZy	whocares
PaloftsoP4	bulldog
hushonwaRi	Password
hooferIf	pass
pautegi30	bitch1
2jdjl	maddog
izodynamaoj	friend
Gladulich7a	131313
snapesgrrlGe	rockyou
alpcrossf0	pastor
pretrpanFR	Terminator123
Grenzbachgj	amanda
ancharib	bullshit
ServanteHy	slipknot
utiligiuc	rangers
difendereBQ	john316
nal1jafY	forum
ett3rR8	passw0rd
tujostWQ	forum
recaireBB	joshua
likovaloOM	hunter
equipoxcaretXA	samantha
gwrtilauUZ	butthead
svenn24Rj	password
MurzynekS6	myspace1
mikuranga2A	computer
CanilliHH	boston
meholo3Y	heaven
staldierac	mother
opljusnemzU	Football
EnsuewsmubmupQr	:the
Babinicz0A	123456
wamataSr	compaq
findungsSA	wilson
arredor0k	love
hustotaJr	pastor
fincharnx	dallas
nejasnoQH	forever
imendancI	1q2w3e
Milenamkh	peaches
luige23JT	1q2w3e
Brederoax	flower1
brukneromcR	password2
MollauTu	compaq
dospevamoyN	loving
bellicosokK	ginger
gnomonicVU	friends
usedotnetaS	ilove
swempoelwA	nascar
caliipzoEd	porsche
innskota3j	
aalwurmPq	tigger
Bidossi1f	Qwertz
rudicieA	pookie
nyxdimensionsc2	Qwertz
gosnidaL6	faith
pavetinanv	princess
aisforaaronVP	faith
historienDr	angel
diskusijulo	fuckyou
bancwyroo	bulldog
MerceCypegH	anthony
viatgisMc	asdfgh
pohanjeiS	123
iamhailiecX	ncc1701
silosaCX	ashley1
gynetos	startrek
noJoshuwamB	stella
orfyddychi4	jesus
kawaiikunaiQg	dancer1
steetebremic6	blabla
glafemEA	deadspin
toopopegleflyMx	123abc
bonnleacvF	jonathan
tolletatTV	yoyo
altiden1n	qazwsx
milungulaK7	batman
apeguents4W	snickers
domoctester30ht	morgan
llyfrifwrvT	winter
DasingpS	Miley
AppealeJawllq	cowboy
unyonismo5g	tiger
Lipardott	mercedes
PlervielaseAo	starwars
NawisksJ	peaches
cloncwydl	cassie
NabshedsseS12	ferrari
garplevR	john316
morfismelo	cheese
sambalanXq	andrea
sueleG5	penguin
Wooster6B	muffin
escapoam8F	sexy
picoreaPN	guest
lyt3xDX	Bitch
PierottiCm	none
estraguRd	midnight
tammyso5k	winner
sac2kuw	golfer
kwana9B	samuel
olgacatasusm8	bigtits
DarrigoY6	nigger1
heppseunseSahS4	panther
Dublinos1	kotaku
tigriniaC0	aaaaaa
karizmamaNr	captain
perfectsLM	black
limpzU	Nicole
avoavoYm	666666
aubainmariesh	myspace1
biogeovelezKI	eminem
vendible2w	Miley
noggymognl	superman
xautumnsunxZZ	blessing
enmascarijk	tigers
hoodiaplus9V	andrew
bijgafmd	hunter
acrortamsKu	pastor
doskakapA	foobar
dehoyH9	jezebel
makojozite	
MasechabaXs	654321
hambreeFK	qwerty12
skjinje50	rangers
bloedlynLW	flower
moutardeXR	pokemon
alkulHr	november
GladulichIt	fucker
isogenesi81	peaches
speentOk	charles
angalanaVh	emmanuel
LeparuloSP	yankees
pastenc6N	jackson
SquariseYO	foobar
tillieDi	steven
BrigeobbeloA5	steven
radiantstarK6	fuckyou
luiswarmkr	123abc
ar4t3akBJ	george
ipspmodFO	snowball
angelawinaN7	qervy
OrawskiRy	rockyou
skimar3v	writer
AgogeniaphanoKe	mike
Schembre5a	martin
Pregljemaq6	seinfeld
podrivenPR	wizard
krektun1Z	angela
merostw6t	nintendo
BenzoylkD	the
BulstenuU	shannon
Dainottonv	Bitch
fizahanaY2	winner
StickhD	connect
HereitUL	turtle
itsaxcrimeXu	asdfasdf
emynmuil3u5	junior
porreeAe	monkey1
embutivagZ	blowme
gewiebeldB1	123
mcphdlF	summer06
skaapvet6S	trustno1
PerfidioGS	elephant
ipotenusaIx	asdfasdf
teranasoF	andrea
sfibrando0r	whocares
darogana5K	bigdick
pnyby23IB	pookie
xredheartrock2K	admin
SodsgoonsAh	soccer
enluadasMW	love123
haniefadrianJs	guitar
youkairinrc	anthony
alhadash4	silver
philiphalliQ	porn
LetochayJ	victoria
freemangcnz	lauren
haven91s	asdfgh
steetebremicG	digital
restsu6	google
embelirib6	poop
tornadoaB	12345678
devojkage	steven
BrottonduloubRu	12345678
nababbel1p	sexy
anatazrh	123qwe
arafusfG	Dick
zoreilleso0	creative
defensatKC	letmein
itscherryishbA	spanky
pengulunmB	harley
ACCRINTrd	rosebud
agnodolK2	iwantu
jigsawfox0i	lovely
Besaultacencebf	cookie
iaestepB	cookie
kdog84mn	hello1
rotsvaste2	miller
i3slav8E	eminem
SeestegPH	wizard
poonkeilamxb	mustang
Altaistrf	cheer1
hissinirm	summer06
feriePv	bitch
AppealeJawlLm	bigtits
kerlaugDp	bitch1
lehavrephotoO3	qwertz
MurzynekcH	666666
iqholooR	Dick
2g1a2nal1T	2000
Nutssteeree4J	11235813
CerkaskioL	maverick
ImmullyLync8O	matthew
boraroaU	pass
versadiguH	asdfghjk
gabakkz	Qwertz
idncaN2	ARMIN
4p3t2AF	destiny
zegrzaninbq	Qwertz
marquesa62xF	hardcore
brooksienloO	hahaha
GnojekqV	alvin123
RugieriuS	heaven
ptolemaic6l	Password2
Ungumyenitc	test123
devilmanndv	booboo
pixelunokF	cookie
domovina3p	elephant
bkemp6u	rockyou
Kazbekox6	blowme
rlz14gP	monkey1
rhovylsZy	Miley
Arennig8F	qazwsx
liprirLO	poopoo
licemerz2	cool
pristaliyt	Killer
Jeremijameq	baseball1
blahblah19851sw	arsenal
Loati0S	merlin
shesxglowingdp	falcon
kusebentagQ	snowball
Hainnaavaipseq8	zxcvbn
nezauzet7M	2000
henessylaraete	696969
paisanIW	bandit
Utrillowiwu	nigga1
tantetamf	cheese
Idiocloffqa	knight
JuchamidO	qwerty
CimarostiOo	butterfl
ugledajuPn	test123
colectoraKc	booger
GambBallialgeV8	ferrari
t3s4laggZ	blessed
bavaneLp	consumer
bilboard66	88888888
akkustiskWK	11235813
escairivaLQ	hope
simulantQQ	111111
luzcaBy	password1
KESEETTIREE5p	jasper
ububwivF	girls
findingxemoxub	muffin
chap027No	camaro
carmenau886Jh	winner
hazywaysy4	money
WuhanaS1	phoenix
lakkeraMx	asdfgh
vickylovecaraR3	hockey
Veldpoue2	camaro
camellerl6	prayer
cerminnyaj3	onelove
ashilavrilkj	prayer
stuctumtubszd	ashley
1a2rany1sGI	7777777
andrwmorarS	cool
SchlappepP	Nicole
ZweistromTt	charles
perfectslQ	volcom1
LaajelAV	merlin
uk2k1o1laga	hello1
vibreerpv	fishing
toma2WM	peanut
e3par9b	victoria
kabaslQ	friends
dawson1123Qb	liverpoo
newjukeboxSC	cowboys
dhikiEL	cheese
singilaai	rachel
hodatiR7	godzilla
jonathaninetuE	1q2w3e
feddalDU	bullshit
ic2c1he7D	rosebud
ZilibottizC	consumer
TanzilloTV	eminem
iogannsbSF	lauren
forlagsB0	enter
arletzQH	fucker
linaresnn	qwerty
jmanuelrapado6Q	7777777
cozileVJ	samantha
ApopayslilisPq6	heaven
tinounb3	taylor
WaigoWeerce7E	q1w2e3r4
KessafB	black
MisiaFq	maddog
howedoitky	corvette
iziqenduzi	deadspin
antigatazkasAZ	shannon
SexologieRz	asdf
DomiciananU	peace
Meghrashm	trinity
inuliwaXl	trustno1
donglejx	jennifer
cornpops05fK	peace
xoxobrenda7T	ilove
tecercenceklyBV	gateway
chukitmugJh	mustang
nezauzetZm	Ashley
rastrojePR	marine
nyczsarahcA	2000
PerruniZC	696969
zeebaby1325o	123
bloedingKg	tigers
RohrachseWK	spiderma
Telekomano	james
Majnoas	yankees
bags249WW	asshole
kiwi411Lw	hotdog
bogdanaxC	digital
meetskale30	cheer1
86400pt	eagles1
swirlzySJ	sample12
zchudnouta0	miller
ukrutnicemw	Highlife
o0dontask0od3	fuckyou!
BayotoA	butterfl
cpn8529V	badboy
szidhatS9	love123
docforbinTe	jasper
bluelnghrn7R	midnight
putoklisVs	pookie
balistimaEl	asshole1
currulloic	helpme
sloppargk	qwert
markbaker001Xn	please
conceditzBy	baseball
sildisoge84	password1
Kgaogayoib	murphy
superman016ce	jason
talbania3Wf	access
Fendrichpv	internet
vorrolhemZE	startrek
treslatemlQ	starwars
ClesceriPV	nicole
cenhedlwnPm	goober
prijavLd	biteme
broffidilb	trustno1
Yeslayidifr	1q2w3e4r
kamaleiE8	Miley
taxedqi	Terminator123
KurheimenwO	asdfghjk
spahujecn	chicago
teirnan60	love123
tilley2zC	bandit
clorurasf7	159753
fluorurohI	dakota
Svastmt	god
vederezDp	steelers
gerescaB4	passw0rd
alpha825Yw	q1w2e3r4
sgaimagensi	asdfasdf
laescuelahaceFg	master
sergionati2V	prayer
LabalmeLb	nirvana
otegaoKN	darkness
conospoipsyB7	hooters
e4l3ex1cf9	love123
dgciid3Z	chicago
micengeziCn	john316
circoncimB5	flower
n5genfT	mypass
ametiwaP3	loving
aflorifl	Password
rrearickYK	yellow
zavezanomcZ	whatever
desasneog	hockey
gabungEL	brooklyn
opatijiiz	tennis
nikkistippickWE	tigger
andiphotoGK	startrek
stagetec06cx	Terminator123
ukazanegaq5	austin
JehovamaRt	bullshit
chemizacewr	robert
epimexicosH	jasper
hartfamRa	love
cymynomma	corvette
huisvasgU	brandon
masterbyronuA	baseball
zukoffernpm	pookie
buddyib2F	bandit
Alsokio	viking
imagedesignQU	crystal
redapporon0	brooklyn
fefusen3M	Killer
ErdregiondF	corvette
botilhetz5q	Jessica
tiraniceHb	fadmin
dhasc6JS	baseball1
mateluci3E	snickers
BootHokSHounkPo	131313
rezoljx	midnight
baveigbl	devil
karstikr	career
asker0q	bitch1
ymoidaesv0Q	silver
gorlereiV	soccer2
ngempelafj	scooby
aehughe2JK	liverpool
napajalar	love
terry5790oK	jezebel
cymargellgU	zxcvbn
tussendekAU	calvin
BeceBoofscr	slipknot
SplitPI	ashley1
yujong52dV	mustang
has73520nx	ashley1
ashleydangitOd	destiny
astormannotfO	swordfis
MoornsmennaGo	work
siropegemrK	mickey
VergeroUp	jordan23
WostlWx	mylove
mandarinablogp2	Password2
oropalzS	london
aznlax4life42	dexter
arterosQW	123456
okumelwedR	grace
kufundza6A	ferrari
sivilim5A	blahblah
babixkimbo5m	brooklyn
deroviemermaa	smokey
zrisamFu	admin123
dileteepoftKB	maverick
mppfilmskm	black
aproxDX	Terminator123
barxalx	blessed
zugeeiltOB	cool
negasvc	viper
ManfreobS	slayer
WontergemrP	asdf
kikiree4V	andrew
tungxlirv	angel
remetoiAm	turtle
strmijomNV	andrew
incrustenHJ	swordfis
Lunochod6k	jonathan
MMDCCLXXVME	brooklyn
gelicauWV	welcome
zamrmlaths	yankees
posudbenaKD	qwert
prodhQz	somethin
kleurden9R	qwerty1
kuyilangapY	snickers
nadutegaVU	159753
litorauRy	writer
debotau6s	rainbow
bigenwchcI	angel1
Sionamg	fuckme
FurbertoffetsNA	Password
klain36TQ	fuckyou2
eltonetee8	faith
kneeshorisk3x	superman
endotiqueDh	daniel
jesminderCT	pastor
ettjoput19518L	1111
zivamisecs	marlboro
silnimaCS	qwerty12
gumytwin87Gk	dakota
sviklujC	lucky
houra55	charles
Risoldi8R	fishing
talivecuY	spiderma
gwengwenaduCC	chris1
loumintopeR0	rainbow
AntonaliC5	myspace1
GittykakhipUn	work
izlizujE6	hotdog
AnfarpX	lakers
toeslauV	monster
PlaiseKePuT	the
halamiGl	mypass
calcinaiodm	ilovegod
porekne9t	thx1138
foguinencix	please
grochQD	edward
viabilizi0U	michelle
Pirklbo	8675309
akagaagaaC8	helpme
ahoneratzxN	mike
Rissapacelg	voodoo
petalei5	taylor
littletohJc	fuckoff
tr2ie2t	88888888
krojile9C	fucker
kolmicerT	hannah
alicelovesyouZc	55555
boschettoyK	baby
trefnedigYm	fuckyou2
veznostVo	jack
saalsakul	master
belgicohp	bulldog
Gabglassyrm	gundam
notoBetteT9	222222
ositotucumanoom	raiders
smurfette87Kl	samantha
drhtajuxl	hello
gehegtAP	12345678
sabluda2A	Ashley
longetjeon	Daniel
ckm884m	123456a
feutretzTV	porsche
trafajliGz	Terminator123
starckinblogta	nintendo
perfildhordie0f	slipknot
domujem67	2000
novasuriecTr	baseball1
rramonaaeV	church
eduktecj3	matrix
ImmusMogsDW	john316
Automodus9J	friends
odsiecz99	2000
ObliniaweewayD0	monkey
lindzazj	william
devoanta5q	AdmUn
coernespotowsmd	heaven
1b2ruZi	loving
SeebeineZx	bigdog
apeguivas2b	iceman
filadoira0z	monkey12
patinetehk	mother
AbdraboZn	nintendo
realnihXN	nigger1
Stokkemdu	mercedes
klifixK	iloveyou
spaisdearuD	gizmodo
BarrosemZn	thx1138
pervalhia6	silver
armdickkh	green
JanickaVo	london
Rectumjc	naruto
neulitA3	alexande
allyandsammmeU	bigdick
repaleigTD	camaro
Odem21	asdfghjk
vilicama2F	knight
BurmachaHB	Miley
rudamc0	jason
WeinertiK	banana
EnquistYH	emmanuel
nochainnogainP7	Killer
unfirtienA6	apple
EPHELIAAFFERIPS	mustang
pjayjiggy420	liverpoo
CDonaver	devil
Qerfst	dragon
IDoce	hope
jZackenzin	simpsons
Vifana	dallas
oWestboden	aaaaaa
1atmosferi	Terminator
HAninalymn	112233
1bluesman9	adidas
Tsminuougs	canada
Bpogrebnu	sex
xodele	victory
4noceri	diablo
hIzenberge	tigger
Rcantavi	hope
snoeldob	Miley
Dalvin99002	gizmodo1
mzabeinanick	charlie
BPilztaste	dancer1
xrazdaj	goober
Gclausuras	kitten
maur4	cameron
hxxhymesxx	55555
tpeaceduke108	football
nanaele	asdfasdf
vbaudassa	buster
nkekapahaukea	snickers
3Dercedrop	angel1
guljanoj	nicole
ASchnarch	tucker
Usalarias	boomer
ihikarusakurai	jordan23
mvts31	ninja
TPypenonaSenny	iloveyou!
Jsna	bullshit
ax7mattjw7x	asdf1234
langeke	kotaku
aSielski	crystal
vsnobbato	11111111
ewynvlieg	696969
4nonanoic	onelove
1adoran	abc123
Fvictorcyuen	austin
avonAnaefe	golf
fgelsvavo	bubbles
bbo2ah	liverpoo
Ghawthornowl	cheer1
TliceViedium	babygirl
Rsladke	chicago
ni1u	qazwsx
zrabbiner	xxxxxx
afarolee	welcome
sarhaizare	ninja
Zcapihonem	ninja
hrezili	winter
OManazzale	rosebud
6papallona	anthony
bsaladeras	destiny
htropinami	8675309
zbelangen	nicole
uattenendo	111111
4figyrnau	pineappl
TFanini	golden
Tobtartych	charlie
Gombratjat	taylor
5Donaasjes	rabbit
pwayini	valleywa
TWergilemu	charles
pscusato	asshole
Lengaphasi	fluffy
Oapavas	angela
XMCMLXXIII	2000
Fbensong	ilove
8Podvincem	link
grhifiant	12345
Bnihalefy	destiny
gsummerbrze07	sparky
rSyster	gandalf
Aembrocam	cool
Mfastandi	arsenal
Lpelgacho	dakota
Qbofokodi	55555
cmotoneges	hello1
sgonitelj	blowme
eCammisuli	girls
Bwayephuza	ilovegod
rperesa	snowball
wdukani	ranger
Criglat	wordpass
0ingenryfoetty	bubbles
wVamyheatema	gawker
Istoetram	nigga1
kjaglanka	saved
RWortzwang	11111111
ralgalapis	1234
LCiloche	sample12
5ronaldomania	qwert
2msteamcabw	spanky
mfasadas	midnight
Nazndudepeter	brooklyn
HTimoneri	butter
dobimniju	drowssap
2Sebrawepses	jack
Cperesa	rabbit
jforfait	Terminator
vletonijom	sparky
iNarcyza	shadow
Grommanicity	church
Cjamonyorker	football1
rAriota	church
hi1u	popcorn
2beanabaybee	football1
scotent	yellow
3fanfareja	midnight
3appolpai	monster
JBriermenO	eagles1
Tmvnuevo	volcom1
Wtamyrabio	password2
Qdisiadau	forever
smotorzaak	samantha
fklap500	matrix
uamoldador	helpme
sAgnolazza	princess
Fxhcobabex	hardcore
rnaziranje	gandalf
tprigodu	pumpkin
Jmwadhamu	samantha
rfichant	junior
iamata	murphy
Eoorsaak	victoria
Dboreddydd	brandy
Valway	cheer1
Ctheclultara	Nicole
sassopissi	birthday
7mecedero	viper
2guw	winner
ppiskov	iloveyou
Ncuil	blink182
1danielius	121212
lPurus	loving
pblauwdruk	london
uzawiji	asshole
8targaire	ashley
Szophyag	blessing
yBrautwahl	peaches
2Maitz	steelers
2gvidlinio	camaro
balesenferia	Lovely
peme	gawker
Vdojarnia	butter
WMornblumumb	test123
XliaiceSeinc	1q2w3e4r
fescolador	gundam
3Belska	buster
ekingfighter	football
Asirenoxiphi	yamaha
fm0r1k	asdfgh
1kwenziwa	purple
Zprinosima	nigga1
6studd3dl0v3	knight
ohIncigh	goober
3apepImmegeJaw	eagles1
cdamalig	adidas
Lkegs08	gawker
cbigboy52690	merlin
4mulberi13	joshua
Sngezimvu	bitch1
Rve2gar	drowssap
PEvoseCose	tennis
Pge1li	stella
aodkritelj	zxcvbnm
yrapinant	tigger
icarlos2468	badboy
Cwito	summer1
6torregats	blahblah
Spikkig	password1
Goreouk	blink182
7Anlauf	liverpool
zartemgukasov	myspace1
Zpsoesolana	Terminator
lBoobtursits	123qwe
2amvetse	maggie
rintimavi	bigdog
Floel	internet
badvansi	badboy
lnereemics	sex
Olimeso	0000
Xicaleb	spanky
OShewPoess	orange1
NSweasejen	111111
Bplatonsk	soccer1
jQuexmyncmunny	Terminator
efrogwitch	myspace1
Vdelbymanu	heaven
0oponer	letmein
tloldf	scooby
paclarent	peanut
nghananar	snickers
9extremelysl0w	asdfgh
Eanxios	testing
qCelluzzi	winner
8deporteslai	november
vzene1i	apple
jpakett	biteme
unemic	123321
xKlinze	diablo
tletrasazules	sample12
4Marchoud	Bitch
Qtetrodama	spider
scapinillar	access
Aslavnost	asdf1234
ssubulado	flower1
Gfirefenix52	pass
2razdiru	danielle
QHoneekigHot	apple
7Rumel	asshole1
9Prunali	madison
amoracha	thunder
Pgolmajee	drowssap
OPelei	black
Vukradenog	10423
KOberbug	liverpool
Cfechador	boston
Hbesjedila	liverpoo
8ro2mim	taylor
Mforfait	Ashley
Aflexionan	:the
3Ajaks	shadow
cPettinau	guest
cgoflzz	222222
okosol	canada
Xeplasuppa	asdf
Ritepsypelyday	flower
penvedarat	andrea
0ddiblenni	1qaz2wsx
iZamara	hahaha
TBoogie	000000
pDadasu	batman
6ninepins	superman
Kenergetik	angel1
amusicxell	access
Wtselana	blink182
Grefortir	cowboy
gpallarega	friend
wAlderotti	bigtits
Wfullmoon0526	snickers
HSey	0000
plaparafrase	ranger
Jdoraslega	rosebud
Rmemoblok	lauren
Jgudamu	hahaha
xCadspaddetA	poop
Ujambes	kitten
DDuracci	Qwertz
lGracardi	wizard
aVitulli	scooby
dhontana	heaven
fshawrtypnay11	sexy
sthet	monkey1
0Abaribi	james
Achantalmalfoy	0000
NNoel	stella
Krastrilla	boston
eGreededagodia	password